o o o o o o o o o w o o o o c o o o o o
o o o w w o o o o o o o w o o o w o o c
o o z z z o o o o o w o o o o o o o o z
o o z c z o c c o z o w o o o o o o o z
o o o w o o w o o z o o o o o o o o o z
o o o o o w w o o o w w o z w z o o o w
o o o z o o w o o o o w o o w o o o o o
z w o z o o o o z o o o o z w z o o o o
z o o z o o o z z o o o o o c o o w o o
z o o c o o o o o c o o o z o z o o w o
z o o o o o w o o o o o o o w o o o w w
z o o o o w w o o o o o o z o z o o o o
z o o z z o o o z z o o o o o o o o o o
z z z z o o o o o z o o o o w o o o o o
o o o o o o o o o o o o o o o o o o w o
o o w o o o c o o o w o o o w o o o z o
o o o o o o c o o o o w w o w o w z o o
o o o z o o o c o z o o o w w o z o w c
c o o z z o o o z z o w o o w z w o c o
o w w o o o w o o o o o c o o o o c o c
