z z z z z z z z z z z z z z z
z o o o o w o o o o w z w w z
z o z z o o o z w c o o o o z
z o z z z o z o o o w o z o z
z o w o o o z o w o w o z o w
z o o o z z z o o o w o z o z
z o z o o z o o z o z o z o z
z o z z o z o z o o z o o o z
z o z o o z o w o z z w z o z
z o z o z o o z o o o o w o z
z o o o z o z z z w w o z o z
w z o z z o o o z o o o w o z
z z o o o z z o w o w w o o z
w z z z o o o o o o o o o z z
w z z z z z z z z z z z z z z
